angle - угол
ant - муравей
apple - яблоко	
arch - выгибать
arm - вооружать
army - армия
bag - сумка
ball - мяч
bank - банк
basin - бассейн
basket - корзина
bath - купаться
bed - кровать
bee - пчела
bell - колокольчик
berry - ягода	
bird - птица
blade - лезвие
board - доска
boat - лодка, судно
bone - кость
book - книга
boot - загружать
bottle - бутылка
box - коробка
boy - мальчик	
brain - мозг
brake - тормоз
branch - отделение
brick - кирпич
bridge - мост
brush - кисть
bucket - ведро
bucket - черпать
bulb - выпирать
button - кнопка
baby - ребёнок
cake - пирог
camera - камера
card - чесать
cart - везти
carriage - вагон
cat - кот
chain - цепь
cheese - сыр	
chest - грудь
chin - подбородок
church - церковь
circle - круг
clock - часы
cloud - облако
coat - пальто
collar - воротник
comb - расчёсывать
cord - шнур, связывать
cow - корова
cup - чашка
curtain - занавес
cushion - подушка
dog - собака
door - дверь	
drain - утечка
drawer - ящик	
dress - одевать
drop - опускать
ear - ухо
egg - яйцо	
engine - двигатель
eye - глаз
face - лицо
farm - ферма
finger - палец
fish - рыба
flag - сигнализировать, флаг
floor - этаж
fly - муха
foot - нога
fork - вилка
fowl - домашняя птица
frame - структура
garden - сад
girl - девочка
glove - перчатка
goat - коза
gun - оружие
hair - волосы
hammer - молоток
hand - рука
hat - шляпа	
head - голова
heart - сердце
hook - крюк, вербовать
horn - рожок	
horse - лошадь
hospital - больница
house - дом
island - остров
jewel - драгоценный камень
kettle - чайник
key - ключ	
knee - колено
knife - нож	
knot - узел
leaf - лист
leg - нога	
library - библиотека
line - очередь	
lip - губа
lock - замок
map - карта
match - спичка
monkey - обезьяна
moon - луна
mouth - жевать
nail - ноготь
neck - обниматься
needle - игла	
nerve - нерв
net - сеть	
nose - нос
nut - орех
office - офис
orange - апельсин
oven - печь
parcel - пакет, распределять
pen - ручка
pencil - карандаш
picture - картина	
pin - прикреплять
pipe - труба
plane - самолёт
plate - пластина
plow - пахать	
pocket - карман
pot - горшок
potato - картофель
prison - тюрьма
pump - насос
rail - рельс, перевозить поездом
rat - крыса
receipt - квитанция	
ring - кольцо
rod - прут	
roof - крыша
root - корень
sail - парус
school - школа
scissors - ножницы
screw - винт
seed - семя
sheep - овцы
shelf - полка
ship - корабль
shirt - рубашка
shoe - ботинок	
skin - кожа
skirt - юбка
snake - змея
sock - носок
spade - лопата
sponge - губка
spoon - ложка
spring - весна
square - квадрат
stamp - печать
star - звезда
station - станция
stem - стебель
stick - палка
stocking - снабжать
stomach - живот 
stomach - смелость
store - магазин
street - улица
sun - солнце
table - стол
tail - хвост
thread - нить
throat - горло
thumb - листать
ticket - билет
toe - палец ноги
tongue - язык
tooth - зуб
town - город
train - поезд
tray - поднос
tree - дерево
trousers - брюки
umbrella - зонт
wall - стена
watch - часы
wheel - колесо
whistle - свист
window - окно
wing - крыло
wire - провод
worm - червь
